MMMMMMMDMMMMMMM
MOOOMOOOMOOMMOM
MOOMMOOMOMOOMOM
MMOMOMOOOOOOOOM
MOOOOMMOOMOMMMM
MOMOOOOOMOOMOOM
MOOMMOMMMMOMOOM
MOOMMOOOMMOOOMM
MOOOOOMOOOMMMMM
MMMMMMOOMOOOOOM
MOOOOOOMMOOOMOM
MOOOMMOOMMOMMOM
MOOMOOOOOMOOOOM
MOMMOOOOMMOOOOM
MMMMMAMMMMMMMMM